2222222222222222222222222222222
2222222222222222222222222222222
2200000000000000000000000000022
2200000000000000000000000000022
2200000111111000001111110000022
2200001000000110110000001000022
2200010000000001000000000100022
2200010000000001000000000100022
2200010000000000000000000100022
2200001000000000000000001000022
2200000100000000000000010000022
2200000010000000000000100000022
2200000001000000000001000000022
2200000000100000000010000000022
2200000000010000000100000000022
2200000000001000001000000000022
2200000000000100010000000000022
2200000000000010100000000000022
2200000000000001000000000000022
2200000000000000000000000000022
2200000000000000000000000000022
2200000000000000000000000000022
2200000000000003000000000000022
2200000000000000000000000000022
2200000000000000000000000000022
2200000000000000000000000000022
2200000000000000000000000000022
2200000000000000000000000000022
2200000000000000000000000000022
2222222222222222222222222222222
2222222222222222222222222222222
