2222222222222222222222222222222
2222222222222222222222222222222
2200000000000000000000000000022
2200000000000000000000000000022
2200000000000000000000000000022
2200000000000000000000000000022
2210001001111010000100000111022
2210001010000010000100001000122
2211111011111010000100001000122
2210001010000010000100001000122
2210001001111011110111100111022
2200000000000000000000000000022
2200000000000000000000000000022
2210101001110011100100001111022
2210101010001010010100001000122
2210101010001011100100001000122
2210101010001010010100001000122
2201110001110010010111101111022
2200000000000000000000000000022
2200000000000000000000000000022
2200000000000000000000000000022
2200000000000000000000000000022
2200000000000000000000000000022
2200000000000003000000000000022
2200000000000000000000000000022
2200000000000000000000000000022
2200000000000000000000000000022
2200000000000000000000000000022
2200000000000000000000000000022
2222222222222222222222222222222
2222222222222222222222222222222
