222222222222222
222222222222222
220000000000022
220000000000022
220000111000022
220001000100022
220000000100022
220000001000022
220000010000022
220000010000022
220000000000022
220000010000022
220000030000022
220000000000022
222222222222222
222222222222222
